11111111111111111
10010000000C00001
10000111110000001
1P0011E00000010C1
10010001110001001
1C0000000C0000001
11111111111111111
